00000000000000000112
00111111111100000100
00100010000111111100
01100010000000000100
01000111100000111100
01001100001111100000
01100000001000000000
00100000001111111000
01111000000000001000
00001000000000001000
00001000000111111000
00001111000100001000
01100001100100001000
00111111000111111000
00001000000000001000
00111111111110001110
01100000100010001000
01000011111010001110
01000010001000000010
31000000000000000000
