01100000000000000112
00111111111000001100
00100010000111111100
01100010000000000100
01000111111000111100
01001100001111100000
01100000001000000000
00000000001111111000
01111000000000001000
00001000110000001000
00001000010111111000
00001111011100001000
01100001100000001000
00111111000111111000
00001000000000001000
00111111111110001110
01100000100010001000
01000011111010001110
00000010001000000010
00000000000000000013
